11 11
A Headmaster Ambrose;5 8
<
H The Commons;3 5 5 0
<
1 3 3
<
#####-#####
#.........#
#.........#
#..$......#
#.........#
#.........#
#.........#
#.........#
#....A....#
#.........#
###########