7 7
<
H Headmaster Ambrose Office;5 1 3 6
<
<
#######
#.....#
#.....#
#.....#
#.....#
#.....#
###-###